1111111111111111111111111111111111
1000000000P0000C00000C0000000000E1
1010010100100000101001000000010101
1010010010101010001001000000010111
100000000C00C000000000000000000001
1111111111111111111111111111111111